###########
#A#     # #
# # ### # #
# # #   # #
#   # ### #
### #     #
#     ### #
# ###     #
#     ###B#
###########
